1111111111111113444444444444444444444444444444444444444444111111111111111111111111111111111444444444444444444444444444444444444444434444444411111111111
1111111111111113444444444444444444444444444444444444444444421111111111111111111111111111114444444444444444444444444444444444444444444444444441111111111
1111111111111113444444444444444444444444444444444444444444422111111111111111111111111111114444444444444444444444444444444444444444444444444441111111111
1111111111111113444444444444444444444444444444444444444444442211111111111111111111111111114444444444444444444444444444444444444444444444444441111111111
1111111111111113444444444444444444444444444444444444444444444211111111111111111111111111114444444444444444444444444444444444444444444444444441111111111
1111111111111113444444444444444444444444444444444444444444444221111111111111111111111111111444444444444444444444444444444444444444444444443411111111111
1111111111111114434444444444444444444444444444444444444444444421111111111111111111111111111444444444444444444444444444444444444444444444444411111111111
1111111111111111444444444444444444444444444444444444444444444422111111111111111111111111111144444444444444444444444444444444444444444443441111111111111
1111111111111111144444444444444444444444444444444444444444444442111111111111111111111111111114443444444444444444444444444444444444444444411111111111111
1111111111111111143444444444444444444444444444444444444444444442111111111111111111111111111111444444444444444444444444444444444444444441111111111111444
4111111111111111114444444444444444444444444444444444444444444442111111111111111111111111111111111443444444444444444444444444444444444111111111111111444
4441111111111111111434444444444444444444444444444444444444444422111111111111111111111111111111111144434444444444444444444444444444411111111111111144444
4444111111111111111143444444444444444444444444444444444444444221111111111111111111111111111111000111444444444444444444444444444444111111111111111144444
4444111111111111111114444444444444444444444444444444444444422211111111111111111111111111111110000011112222444444444444444444411111111111111111111444444
4444411111111111111111144444444444444444444444444444444422221111111111111111111111111111111110000022222222222222222222222221111111111111111111114444444
4444441111111111111111114444444444444444444444444444444221111111111111111111111111111111111100000002222222222222222222222222211111111111111111144444444
4444444411111111111111111144344444444444444444444444442221111111111111111111111111111111122200000002222222222222222222222222222211111111111111444444444
4444444441111111111111111114444444444444444444444444442111111111111111111111111111111111222200000002222222222222222222222222222222211111111111444444444
4444444441111111111111111111144444444444444444444444442111111111111111111111111111112222222000000000222333333333333333222222222222222111111114444444444
4444444444411111111111111111111111114444444444444444411111111111111111111111111111222222222000000000333333333333333333332222222222222211111114444444444
4444444444441111111111111111111111111144444444444441111111111111111111111111122222222222222000000000033333333333333333333322222222222221111144444444444
4444444444444441111111111111111111111111333333111111111111111111111111111122222222222222220000000000033333333333333333333333322222222222111144444444444
4444444444444444111111111111111111111111122221111111111111111111111111022222222222222222220000030000033333334444444433333333333222222222111444444444444
4444444444444444111111111111111111111111111111111111111111111122222220000222222222222222200000030000003334444444444444333333333322222222111444444444444
4444444444444444441111111111111111111111111111111111111111112222222222200000000000000000000000333000000000000000000044444333333332222222111444444444444
4444444444444444441111111111111111111111111111111111111111122222222222200000000000000000000000333000000000000000000004444443333332222222111444444444444
4444444444444444344111111111111111111111111111111111111111222222222222220000000000000000000000333000000000000000000004444444333333222222111444444444444
4444444444444444444111111111111111111111111111111111222222222222222222220000000000000000000003333300000000000000000004444444443333222222214444444444444
4444444444444444444411111111111111111111111111111122222222222222222222222220000000000000000033333340000000000000000054444444444333322222214444444444444
4444444444444444444411111111111111111111111111222222222222222222222222222222000000000001233333333344444440000000000555554444444333322222214444444444444
4444444444444444444441111111111111111111111112222222222222222222222222222222220000000001233333334444444400000000055555554444444433322222224444444444444
4444444444444444444441111111111111111111111122222222222222222222222222222222222200000000033333444444440000000005555555555444444433322222244444444444444
4444444444444444444444111111111111111111111222222222222222222222222222222222222220000000003333444444400000000055555555555544444433322222244444444444444
4444444444444444444444111111111111111111111222222222222222222222222222222222222222200000003333444444400000006666655555555554444433322222244444444444444
4444444444444444444444411111111111111111111222222222222222222222222222222222222222220000003333444444400000066666666555555554444433322222244444444444444
4444444444444444444444411111111111111111111222222222222222222222222222222221222222222000002333444444400000666666666665555554444333322222244444444444444
4444444444444444444444411111111111111111111122222222222222222222222221111122222222220000002333400444400000066666666665555554443333322222244444444444444
4444444444444444444444411111111111111111111122222122211112222222222111111111212222220000022230000044440000066666666665555554443333322222244444444444444
4444444444444444444444441111111111111111111111222221111111111111111111111111222122220000022000000000440000066666666665555544433333322222244444444444444
4444444444444444444444444411111111111111111111111111111111111111111111111111112212200000000000000000004000006666666655555544433333322222214444444444444
4444444444444444444444444411111111111111111111111111111111111111111111111111111221200000000000000000000000005666666655555444433333322222114444444444444
4444444444444444444444444441111111111111111111111111111111111111111111111111111112200000000000000000000000000666666555554444433333322222214444444444444
4444444444444444444444444441111111111111111111111111111111111111111111111111111111000000000000333000000000000555555555554444433333222222214444444444444
4444444444444444444444444441111111111111111111111111111111111111111111111111111111000000000033333330000000000555555555444444433333222222211444444444444
4444444444555444444444444441111111111111111111111111111111111111111111111111111110000000000232333334400000000055555555444444333332222221211444444444444
5555555555555555444444444445555555555111111111111111111111111111111111111111111110000000022233333334440000000055555444444444333332222222211144444444444
5555555555555555555555555555555555555555555111111111111111111111111111111111111111000002222222333334444400000444444444444444333322222222111144444444444
5555555555555555555555555555555555555555555555111111111111111111111111111111111111000222222222333334444444000444444444444443333222222221111114444444444
5555555555555555555555555555555555555555555555551111111111111111111111111111111111111122222222333333444444444444444444444443333222222121111111444444444
5555555555555555555555555555555555555555555555555551111111111111111111111111111111111112222222233333444444444444444444444433332222221221111111144444444
5555555555555555555555555555555555555555555555555555555111111111111111111111111111111012222222223333344444444444444444444333222222222211111111144444444
5555555555555555555555555555555555555555555555555555555511444111111111111111111111111112222222223333334444444444444444443332222222212111111111114444444
5555555555555555555555555555555555555555555555555555555554444444441111111111111111111111222222222333333333444444444333333332222222122111111111111144444
5555555000000555555555555555555555555555555555555555555555444444444411111111111111111111222222222233333333333333333333333222222221221111111111111144444
0000000000000000000000055555555555545555555555555555555555444444444411111111111111111111111222222222333333333333333333322222222222211111111111111114444
0000000000000000000000000000005555555555555555555555555555444444444441111111111111111111111122222222222222222233333322222222222222111111111111111111111
0000000000000000000000000000000000000550005545555555555555444444444441111000000000111111111110222222222222222222222222222222222221111111111111111111111
0000000000000000000000000000000000000000000555555555555555444444444440000000000000001111111111022222222222222222222222222222222211111111111111111111111
0001111111000000000000000000000000000000000005505555555554444444444440000000000000000011111111111222222222222222222222222222222111111111111111111111111
1111111111111110000000000000000000000000000000000000555544444444444340000000000000000001111111111122222222222222222222222222221111111111111111111111111
1111111111111111111000000000000000000000000000000000504444444444444440000000000000000001111111111111112221222222222222221222111111111111111111111111111
1111111111111111111111111000000000000000000000000000000004444444444000000000000000000000111111111111111122222222222222222211111111111111111111111111111
1111111111111111111111111111110000000000000000000000000000004444440000000000000000000000011111111111111111111112222221111111111111111111111111111111111
1111111111111111111111111111111111111100000000000000000000000000000000000000000000000000001111111111111111111111111111111111111111111111111111111111111
1111111111111111111111111111111111111111100000000000000000000000000000000000000000000000001111111111111111111111111111111111111111111111111111111111111
1111111111111111111111111111111111111111111110000000000000000000000000000000000000000000000111111111111111111111111111111111111111111111111111111111111
1111111111111111111111111111111111111111111111111000000000000000000000000001111000000000000011111111111111111111111111111111111111111111111111111111111
1111111111111111111111111111111111111111111111111111000000000000000000000111111111000000000011111111111111111111111111111111111111111111111111111111111
1111111111111111111111111111111111111111111111111111110000000000000000001111111111110000000011111111111111111111111111111111111111111111111111111111111
1111111111111111111111111111111111111111111111111111111111110000000001111111111111111100000011111111111111111111111111111111111111111111111111111111111
1111111111111111111111111111111111111111111111111111111111111110111111111111111110111100000011111111111111111111111111111111111111111111111111111111111
1111111111111111111111111111111111111111111111111111111111111111111111111111111111111111000011111111111111111111111111111111111111111111111111111111111
1111111111111111111111111111111111111111111111111111111111111111111111111111111111111111000011111111111111111111111111111111111111111111111111111111111
1111111111111111111111111111111111111111111111111111111111111111111111111111111111111111100011111111111111111111111111111111111111111111111111111111111
1111111111111111111111111111111111111111111111111111111111111111111111111111111111111111100011111111111111111111111111111111111111111111111111111111111
1111111111111111111111111111111111111111111111111111111111111111111111111111111111111111111111111111111111111111111111111111111111111111111111111111111
1111111111111111111111111111111111111111111111111111111111100011111111111111111111111111111111111111111111111111111111111111111111111111111111111111111
1111111111111111111111111111111111111111111111111111111111100011111111111111111111111111111111111111111111111111111111111111111111111111111111111111111
1111111111111111111111111111111111111111111111111111111111100001111111111111111111111111111111111111111111111111111111111111111111111111111111111111111
1111111111111111111111111111111111111111111111111111111111100001111111111111111111111111111111111111111111111111111111111111111111111111111111111111111
1111111111111111111111111111111111111111111111111111111111100000011110111111111111111110111111111111111111111111111111111111111111111111111111111111111
1111111111111111111111111111111111111111111111111111111111100000011111111111111111000000000111111111111111111111111111111111111111111111111111111111111
1111111111111111111111111111111111111111111111111111111111100000000111111111111000000000000000000111111111111111111111111111111111111111111111111111111
1111111111111111111111111111111111111111111111111111111111100000000001111111110000000000000000000001111111111111111111111111111111111111111111111111111
1111111111111111111111111111111111111111111111111111111111100000000000001111000000000000000000000000001111111111111111111111111111111111111111111111111
1111111111111111111111111111111111111111111111111111111111110000000000000000000000000000000000000000000000111111111111111111111111111111111111111111111
1111111111111111111111111111111111111111111111111111111111111000000000000000000000000000000000000000000000000011111111111111111111111111111111111111111
1111111111111111111111111111111111111111111111111111111111111000000000000000000000000000000000000000000000000000011111111111111111111111111111111111111
1111111111111111111111111111111111222222111111111111111111111100000000000000000000000444444000000000000000000000000000000111111111111111111111111111111
1111111111111111111111111111122222222222222222211111111111111110000000000000000000004444444444000000000000000000000000000000001111111111111111111111111
1111111111111111111111111112221222222222222221222111111111111111000000000000000000444444444444444050000000000000000000000000000000001111111111111111111
1111111111111111111111111222222222222222222222222222211111111111000000000000000000434444444444455550000000000000000000000000000000000000111111111111111
1111111111111111111111112222222222222222222222222222221111111111100000000000000000444444444444555555555055000000000000000000000000000000000001111111000
1111111111111111111111122222222222222222222222222222222201111111111000000000000000444444444445555555555555550000000000000000000000000000000000000000000
1111111111111111111111222222222222222222222222222222222220111111111110000000001111444444444445555555555555455000550000000000000000000000000000000000000
1111111111111111111112222222222222233333322222222222222222211111111111111111111111444444444445555555555555555555555555555000000000000000000000000000000
4444111111111111111122222222222233333333333333333332222222221111111111111111111111144444444445555555555555555555555455555555555500000000000000000000000
4444411111111111111221222222223333333333333333333333322222222221111111111111111111144444444445555555555555555555555555555555555555555555550000005555555
4444411111111111112212222222333333334444444443333333332222222221111111111111111111111444444444555555555555555555555555555555555555555555555555555555555
4444444111111111112122222222333444444444444444444333333222222222111111111111111111111111114441155555555555555555555555555555555555555555555555555555555
4444444411111111122222222223334444444444444444444433333222222222101111111111111111111111111111115555555555555555555555555555555555555555555555555555555
4444444411111111221222222333344444444444444444444443333322222222111111111111111111111111111111111111555555555555555555555555555555555555555555555555555
4444444441111111212222223333444444444444444444444443333332222222211111111111111111111111111111111111111555555555555555555555555555555555555555555555555
4444444444111111222222223333444444444444440004444444333332222222220001111111111111111111111111111111111115555555555555555555555555555555555555555555555
4444444444411112222222233334444444444444440000044444333332222222000001111111111111111111111111111111111111115555555555555555555555555555555555555555555
4444444444411122222222333334444444445555500000000444333333322200000000111111111111111111111111111111111111111111115555555555444444444445555555555555555
4444444444441121222222333334444445555555500000000044333332320000000000111111111111111111111111111111111111111111111111111111444444444444445554444444444
4444444444441122222223333344444445555555550000000000333333300000000001111111111111111111111111111111111111111111111111111111444444444444444444444444444
4444444444444122222223333344444555555555550000000000003330000000000001111111111111111111111111111111111111111111111111111111444444444444444444444444444
4444444444444122222233333344444555556666660000000000000000000000000022111111111111111111111111111111111111111111111111111111444444444444444444444444444
4444444444444112222233333344445555566666665000000000000000000000000021221111111111111111111111111111111111111111111111111111144444444444444444444444444
4444444444444122222233333344455555566666666000004000000000000000000022122111111111111111111111111111111111111111111111111111144444444444444444444444444
4444444444444422222233333344455555666666666600000440000000002200000222212221111111111111111111111111222221111111111111111111111444444444444444444444444
4444444444444422222233333444555555666666666600000444400000322200000222222121111111112222222222111122212222211111111111111111111144444444444444444444444
4444444444444422222233333444555555666666666600000044440043332000000222222222211111222222222222222222222222211111111111111111111144444444444444444444444
4444444444444422222233334444555555666666666660000044444443332000002222222221222222222222222222222222222222221111111111111111111144444444444444444444444
4444444444444422222233344444555555556666666600000044444443333000000222222222222222222222222222222222222222221111111111111111111144444444444444444444444
4444444444444422222233344444555555555566666000000044444443333000000022222222222222222222222222222222222222221111111111111111111114444444444444444444444
4444444444444422222233344444455555555555500000000044444443333000000000222222222222222222222222222222222222221111111111111111111114444444444444444444444
4444444444444422222233344444445555555555000000000444444443333300000000022222222222222222222222222222222222211111111111111111111111444444444444444444444
4444444444444222222233344444444555555500000000044444444333333321000000000222222222222222222222222222222222111111111111111111111111444444444444444444444
4444444444444122222233334444444555550000000000444444433333333321000000000002222222222222222222222222222221111111111111111111111111144444444444444444444
4444444444444122222233334444444444500000000000000000433333300000000000000000222222222222222222222222211111111111111111111111111111144444444444444444444
4444444444444122222223333444444444000000000000000000033333000000000000000000000222222222222222222221111111111111111111111111111111114444444444444444444
4444444444441112222223333334444444000000000000000000003330000000000000000000000222222222222221111111111111111111111111111111111111114434444444444444444
4444444444441112222222333333444444000000000000000000003330000000000000000000000022222222222211111111111111111111111111111111111111111444444444444444444
4444444444441112222222333333334444400000000000000000003330000000000000000000000022222222222111111111111111111111111111111111111111111444444444444444444
4444444444441112222222233333333334444444444444333000000300000022222222222222220000222222211111111111111111111111111111111111111111111114444444444444444
4444444444441112222222223333333333344444444333333300000300000222222222222222222201111111111111111111111111222211111111111111111111111114444444444444444
4444444444411112222222222233333333333333333333333300000000000222222222222222211111111111111111111111111113333331111111111111111111111111444444444444444
4444444444411111222222222222233333333333333333333300000000002222222222222211111111111111111111111111444444444444411111111111111111111111111444444444444
4444444444111111122222222222222333333333333333333330000000002222222221111111111111111111111111111144444444444444444111111111111111111111111144444444444
4444444444111111112222222222222223333333333333332220000000002222222111111111111111111111111111112444444444444444444444444411111111111111111111444444444
4444444441111111111122222222222222222222222222222222000000022221111111111111111111111111111111112444444444444444444444444444111111111111111111444444444
4444444441111111111111122222222222222222222222222222000000022211111111111111111111111111111111222444444444444444444444444434411111111111111111144444444
4444444411111111111111111122222222222222222222222222000000011111111111111111111111111111111111224444444444444444444444444444444111111111111111111444444
4444444111111111111111111111222222222222222222222222200000111111111111111111111111111111111222244444444444444444444444444444444411111111111111111144444
4444441111111111111111111144444444444444444442222111100000111111111111111111111111111111122244444444444444444444444444444444444444111111111111111114444
4444411111111111111114444444444444444444444444444441110001111111111111111111111111111111224444444444444444444444444444444444444443411111111111111114444
4444411111111111111144444444444444444444444444444344411111111111111111111111111111111112244444444444444444444444444444444444444444341111111111111111444
4441111111111111114444444444444444444444444444444443441111111111111111111111111111111112444444444444444444444444444444444444444444444111111111111111114
4441111111111111444444444444444444444444444444444444444441111111111111111111111111111112444444444444444444444444444444444444444444443411111111111111111
1111111111111144444444444444444444444444444444444444443444111111111111111111111111111112444444444444444444444444444444444444444444444411111111111111111
1111111111111443444444444444444444444444444444444444444444411111111111111111111111111112244444444444444444444444444444444444444444444441111111111111111
1111111111144444444444444444444444444444444444444444444444441111111111111111111111111111244444444444444444444444444444444444444444444344111111111111111
1111111111143444444444444444444444444444444444444444444444441111111111111111111111111111224444444444444444444444444444444444444444444443111111111111111
1111111111444444444444444444444444444444444444444444444444444111111111111111111111111111124444444444444444444444444444444444444444444443111111111111111
1111111111444444444444444444444444444444444444444444444444444111111111111111111111111111122444444444444444444444444444444444444444444443111111111111111
1111111111444444444444444444444444444444444444444444444444444111111111111111111111111111112244444444444444444444444444444444444444444443111111111111111
1111111111444444444444444444444444444444444444444444444444444111111111111111111111111111111244444444444444444444444444444444444444444443111111111111111
1111111111144444444344444444444444444444444444444444444444441111111111111111111111111111111114444444444444444444444444444444444444444443111111111111111
